R 1000 600

NO ./north
SO ./south
WE ./west
EA ./east
S ./sprite


F 220,100,0
C 225,30,0



111111111
1SE010001
100000001
100000001
100000001
100000001
111111111
