R 1000 600

NO ./assets/textures/portal_wall_1.xpm
SO ./assets/textures/portal_wall_2.xpm
WE ./assets/textures/portal_wall_3.xpm
EA ./assets/textures/portal_wall_4.xpm
S ./assets/textures/portal_turret.xpm


F 220,100,0
C 225,30,0


111111111111111111111111
100000000210000001000001
1000000000L000000L000001
100000000K10000001000001
10000000K011111111111111
100000000011111111111111
100000000011111111111111
100000000011111111111111
100000000011111111111111
100000000011111111111111
100000000011111111111111
100000000011111111111111
100000000011111111111111
100000000011111111111111
100000000011111111111111
100000000011111111111111
100000000011111111111111
100000000011111111111111
1000N0000011111111111111
111111111111111111111111
