R 1000 600

NO ./assets/textures/portal_wall_1.xpm
SO ./assets/textures/portal_wall_2.xpm
WE ./assets/textures/portal_wall_3.xpm
EA ./assets/textures/portal_wall_4.xpm
S ./assets/textures/portal_turret.xpm


F 220,100,0
C 225,30,0


111111111111111111111111111111111111111111111111111111111111111111111111111111111111
100000000110000001000000000000000000000000000000000000000000000000000000000000000011
1000000001D0000W0D0000000000000000000000000000000000000000000000000000000000000000L1
10000000011000000100000000000000K000000000000000000000000000000000000000000000000011
111111111111111111111111111111111111111111111111111111111111111111111111111111111111
