R 1000 600

NO ./assets/textures/portal_wall_1.xpm
SO ./assets/textures/portal_wall_2.xpm
WE ./assets/textures/portal_wall_3.xpm
EA ./assets/textures/portal_wall_4.xpm
S ./assets/textures/portal_turret.xpm


F 220,100,0
C 225,30,0


111111
10K021
100001
1N00L1
111111
