R 1000 600

NO ./assets/textures/portal_wall_1.xpm
SO ./assets/textures/portal_wall_2.xpm
WE ./assets/textures/portal_wall_3.xpm
EA ./assets/textures/portal_wall_4.xpm
S ./assets/textures/portal_turret.xpm


F 220,100,0
C 225,30,0


111111111111111111111
1222220000L000001K001
1K2220000011111010001
122220000010001D10001
12200000001N00D0111D1
12000000001l111010001
111111111110001010001
100000000010001010001
1001d11000D00010111D1
10010K101111111Dd0001
1L1111111110001D10001
1L11111111100K10111D1
1L1111111111D11010001
100000000010001010001
1KKKKKKKKK10001010001
1KKKKKKKKK100010111D1
1KKKKKKKKK1D111010001
1111DDD11110000010001
1LLLLLLLLL111111111d1
1LLL000LLL10000000001
1LLL000LLL1K000000001
111111111111111111111
