
R 1920 1080 
NO ./textures/colorstone.xpm
SO ./textures/bluestone.xpm

WE ./textures/greystone.xpm
EA ./textures/wood.xpm

S ./textures/barrel.xpm
F 255,248,220
C 255,206,250
        1111111111111111111111111
        1000000000110000000000001
        1011000001110000002000001
        1001000000000000000000001
111111111011000001110000000000001
100000000011000001110111111111111
11110111111111011100000000001
11110111111111011101010000001
11000000110111111100000000101
1000200000001 101100002200001
10000000000011100010122000001
11000001110101011111011110N0111
11110101 1110101 101111010001
11111111 1111111 111111111111