
R 1920 1080 
NO ./textures/colorstone.xpm
SO ./textures/bluestone.xpm

WE ./textures/greystone.xpm
EA ./textures/wood.xpm

S ./textures/barrel.xpm
F 255,248,220



C 125,206,250


        1111111111111111111111111
111111111000000001222222222222201
        1011000001200000000000021
        1001000001000000000000021
111111111011000000000000000002221
100000000011000000000000000111111
11110111111111011100000000001
11110111100000000000000000001
11000000000000011100000000001
10000000000000001100000000001
10000000000000000000000000001
11000001110101011111000000N0111
11110001 1110101 101000000001
11111111 1111111 111111111111