
R      1920   1080 
NO                 ./textures/colorstone.xpm
SO   ./textures/bluestone.xpm

WE     ./textures/greystone.xpm
EA   ./textures/wood.xpm

S                ./textures/barrel.xpm
F    255  ,  248  ,  220




C 125   ,206,  250





        1111111111111111111111111
111111111000000001000000200000001
        1011000001000000000000001
        1001000001000000000000001
111111111011000000000000000000001
100000000011000000000000000111111
11110000000000000000000000001
11110111111110000000000000001
1100001     10011100000000001
10000011111110001100000000001
10000000000000000000000000001
11000001110101011111000000S0111
11110001 1110101 101000000001
11111111 1111111 1111111111111